12
1,5,7,5,5,5,5,5,5,5,5,6
3,5,13,5,5,5,5,5,4,3,6,10
10,1,5,5,5,5,5,7,6,10,10,10
10,3,7,7,7,7,6,10,10,10,10,10
10,11,15,15,15,13,12,10,10,10,10,10
10,11,15,15,14,3,6,10,10,10,10,10
10,11,13,13,15,13,12,10,10,10,10,10
10,10,3,7,15,7,6,10,10,10,10,10
10,10,9,13,13,12,10,10,10,10,10,10
10,10,1,5,5,5,13,12,10,10,10,10
9,13,5,5,5,5,5,5,13,12,10,10
1,5,5,5,5,5,5,5,5,5,13,12
